# E #
#   #
# . #
### #
#   #
# # #
#   #
#   #
# @ #
