#####
#. E#
#   #
#  ##
#   #
#@  #
#####
