###########
#       E.#
# ## ######
#x## #
# ## #
#x####
# #
#@#
###