#########
#      E#
#    $  #
####.####
#  $    #
#@      #
#########