#####
# E #
#   #
#   #
#   #
#   #
# @ #
#####