#########
#      E#
#    x  #
####.####
#  $    #
#@      #
#########