#####
##E$#
#   #
# # #
# # #
# # #
#   #
#$@##
#####