#####
#. E#
##  #
## ##
#   #
#@  #
#####