######
#@   #
#$#$##
### ##
###  #
#.$  #
######