#######
#.$   #
#$# # #
#     #
# # # #
#    @#
#######