#############
#@       $  #
# ### ### ###
# # #   #$ $#
# # ######$ #
# #  $   $  #
# ######$#$$#
#  $  #$   $#
##### $ ### #
#    $#   # #
# ##$#$$#$# #
#  $      #E#
#############